1 3 3 3 3 3 3 3 3 3 3 3 3 3 3 3 3 3 3 3 3 3 3 3 3 3 3 3 3 3 3 4 
17 8 8 8 8 8 8 8 8 8 8 8 8 8 8 8 8 8 8 8 8 8 8 8 8 8 8 8 8 8 8 20 
17 8 8 8 8 8 8 8 8 8 8 8 8 8 8 8 8 8 8 8 8 8 8 8 8 8 8 8 8 8 8 20 
17 8 8 8 8 8 8 8 8 8 8 8 8 8 8 8 8 8 8 8 14 14 14 14 14 14 14 14 14 8 8 20 
17 8 8 8 8 8 8 8 8 8 8 8 8 8 8 8 8 8 8 8 14 8 8 8 8 8 8 8 14 8 8 20 
17 8 8 8 8 8 14 14 14 8 8 8 8 8 8 8 8 8 8 8 14 8 8 8 8 8 8 8 14 8 8 20 
17 8 8 8 8 8 14 14 14 8 8 14 14 8 8 8 8 8 8 8 14 8 14 14 14 14 14 8 14 8 8 20 
17 8 8 8 8 8 14 14 14 8 8 14 14 8 8 8 8 8 8 8 14 8 14 14 14 14 14 8 14 8 8 20 
17 8 8 8 8 8 8 8 8 8 8 8 8 8 8 8 8 8 8 8 14 8 8 8 8 8 8 8 14 8 8 20 
17 8 8 8 8 8 8 8 8 8 8 8 8 8 8 8 8 8 8 8 14 8 8 8 8 8 8 8 14 8 8 20 
17 8 8 8 8 8 8 8 8 8 8 8 8 8 8 8 8 8 8 8 14 14 14 8 8 8 14 14 14 8 8 20 
17 8 8 8 14 14 14 8 8 8 8 8 8 8 8 8 8 8 8 8 8 8 8 8 8 8 8 8 8 8 8 20 
17 8 8 8 14 14 14 8 8 8 8 8 8 8 8 8 8 8 8 8 8 8 8 8 8 8 8 8 8 8 8 20 
17 8 8 8 8 8 8 8 8 8 8 8 8 8 8 14 14 8 8 8 8 8 8 8 8 8 8 8 8 8 8 20 
17 8 8 8 8 8 8 8 8 8 8 8 8 8 14 14 14 14 8 8 8 8 8 8 8 8 8 8 8 8 8 20 
17 8 8 8 8 8 8 8 8 8 8 8 8 14 14 8 8 14 14 8 8 8 8 8 8 8 8 8 8 8 8 20 
17 8 8 8 8 8 8 8 8 8 8 8 14 14 8 8 8 8 14 14 8 8 8 8 8 8 8 8 8 8 8 20 
17 8 8 8 8 8 8 8 8 8 8 8 8 8 8 8 8 8 8 8 8 8 8 8 8 8 8 8 8 8 8 20 
17 8 8 8 8 8 8 8 8 8 8 8 8 8 8 8 8 8 8 8 8 8 8 8 8 8 8 8 8 8 8 20 
17 8 8 8 8 8 8 8 8 8 14 14 8 8 8 8 8 8 8 8 14 14 8 8 8 8 8 8 8 8 8 20 
17 8 8 8 8 8 8 8 8 14 14 14 14 8 8 8 8 8 8 14 14 14 14 8 8 8 8 8 8 8 8 20 
17 8 8 8 8 8 8 8 14 14 8 8 14 14 8 8 8 8 14 14 8 8 14 14 8 8 8 8 8 8 8 20 
17 8 8 8 8 8 8 14 14 8 8 8 8 14 14 8 8 14 14 8 8 8 8 14 14 8 8 8 8 8 8 20 
17 8 8 8 8 8 8 8 8 8 8 8 8 8 8 8 8 8 8 8 8 8 8 8 8 8 8 8 8 8 8 20 
17 8 8 8 8 8 8 8 8 8 8 8 8 8 8 8 8 8 8 8 8 8 8 8 8 8 8 8 8 8 8 20 
17 8 8 8 8 8 8 8 8 8 8 8 8 8 8 8 8 8 8 8 8 8 8 8 8 8 8 8 8 8 8 20 
17 8 8 8 8 8 8 8 8 8 8 8 8 8 8 8 8 8 8 8 8 8 8 8 8 8 8 8 8 8 8 20 
17 8 8 8 8 8 8 8 8 8 8 8 8 8 8 8 8 8 8 8 8 8 8 8 8 8 8 8 8 8 8 20 
17 8 8 8 8 8 8 8 8 8 8 8 8 8 8 8 8 8 8 8 8 8 8 8 8 8 8 8 8 8 8 20 
17 8 8 8 8 8 8 8 8 8 8 8 8 8 8 8 8 8 8 8 8 8 8 8 8 8 8 8 8 8 8 20 
17 8 8 8 8 8 8 8 8 8 8 8 8 8 8 8 8 8 8 8 8 8 8 8 8 8 8 8 8 8 8 20 
25 27 27 27 27 27 27 27 27 27 27 27 27 27 27 27 27 27 27 27 27 27 27 27 27 27 27 27 27 27 27 28 
