0 15 23 23 13 0 0 0 15 23 23 13 0 0 0 15 23 23 13 0 0 0 0 0 0 0 0 0 0 0 0 0 
0 21 8 8 21 0 0 0 21 8 8 21 0 0 0 21 8 8 21 0 0 0 0 0 0 0 0 0 0 0 0 0 
15 13 8 8 21 23 23 23 13 8 8 21 23 23 23 13 8 8 21 23 23 23 23 23 23 23 23 23 23 23 23 13 
21 8 8 8 6 8 8 8 8 8 8 6 8 8 8 8 8 8 6 8 8 8 8 8 8 8 8 8 8 8 8 21 
21 8 8 8 8 8 8 8 8 8 8 8 8 8 8 8 8 8 8 8 8 14 8 8 14 8 8 14 14 8 8 21 
21 8 8 8 8 8 8 8 8 8 8 8 8 8 8 8 8 8 8 8 8 8 8 8 8 8 8 8 8 8 8 21 
15 23 23 23 23 23 23 23 23 23 23 23 23 23 23 23 23 23 23 23 23 23 23 23 23 23 13 8 8 15 23 23 
0 0 0 0 0 0 0 0 0 0 21 8 8 21 0 0 0 0 0 0 0 0 0 0 0 0 21 8 8 21 0 0 
0 23 23 23 23 23 22 23 23 23 13 8 8 15 23 23 23 23 23 23 23 23 23 23 23 23 13 8 8 15 23 23 
21 8 8 8 8 8 6 8 8 8 8 8 8 8 8 8 8 8 8 8 8 8 8 8 8 8 8 8 8 8 8 21 
21 8 8 8 22 8 8 8 8 8 8 8 8 8 8 8 8 8 8 8 8 8 8 8 8 8 8 8 22 8 8 21 
15 23 23 23 6 23 23 23 23 23 23 23 23 23 23 23 23 23 23 23 23 23 23 23 23 23 23 23 6 23 23 13 
