1 3 3 3 3 3 3 4 0 1 3 3 3 3 4 0 
17 16 16 16 16 16 16 12 0 17 16 16 16 16 7 4 
17 16 16 16 16 16 16 7 3 5 16 31 29 16 16 12 
17 16 16 16 16 16 16 16 16 16 19 7 5 16 16 12 
17 16 16 16 16 16 16 16 16 18 18 19 16 16 16 12 
17 16 16 16 16 16 16 18 16 18 18 19 16 16 16 12 
25 26 26 29 16 16 16 16 16 16 16 36 23 23 35 28 
1 3 4 17 16 16 19 16 16 16 16 21 16 16 20 0 
17 16 12 17 16 18 16 16 22 16 15 45 16 16 7 4 
25 26 28 17 16 16 16 18 21 16 16 16 18 16 16 20 
0 0 0 25 29 16 31 26 41 16 16 16 16 16 16 20 
1 3 3 4 17 16 12 0 17 16 15 23 37 16 16 20 
17 16 16 12 17 16 12 0 17 16 16 16 6 16 16 20 
17 16 16 7 5 16 12 0 17 16 16 16 16 16 16 20 
17 16 16 16 16 16 12 0 25 26 26 26 26 26 26 28 
25 26 26 26 26 26 28 0 0 0 0 0 0 0 0 0 
