0 0 0 0 0 0 0 0 0 1 3 3 3 3 21 0 
0 0 1 3 3 3 3 4 0 17 18 18 18 18 23 4 
0 0 17 18 18 18 18 23 3 21 18 31 29 18 18 12 
0 0 17 18 18 18 18 18 18 18 18 7 5 18 18 12 
0 0 17 18 18 18 18 18 18 18 18 18 18 18 18 12 
0 0 17 18 18 18 18 18 18 18 18 18 18 18 18 12 
0 0 25 21 18 18 18 18 18 14 18 23 26 26 26 28 
1 3 4 17 18 18 18 18 18 18 18 12 18 18 20 0 
17 18 12 17 18 18 18 18 22 18 23 28 18 18 20 0 
25 26 28 17 18 18 18 18 12 18 18 18 18 18 20 0 
0 0 0 25 21 18 23 26 28 18 18 18 18 18 20 0 
0 0 0 0 17 18 12 0 17 18 23 26 21 18 20 0 
1 3 3 4 17 18 12 0 17 18 18 18 18 18 20 0 
17 18 18 7 5 18 12 0 17 18 18 18 18 18 20 0 
17 18 18 18 18 18 12 0 25 26 26 26 26 26 28 0 
25 26 26 26 26 26 28 0 0 0 0 0 0 0 0 0 
