5 5 5 5 5 5 5 6 0 0 0 0 0 0 0 0 0 0 0 0 0 0 0 0 0 0 0 0 0 0 0 0 
5 5 5 5 5 5 5 6 0 0 0 0 0 0 0 0 0 0 0 0 0 0 0 0 0 0 0 0 0 0 0 0 
5 5 5 5 5 5 5 6 0 0 0 0 0 0 0 0 0 0 0 0 0 0 0 0 0 0 0 0 0 0 0 0 
5 5 5 5 5 5 5 6 0 0 0 0 0 0 0 0 0 0 0 0 0 0 0 0 0 0 0 0 0 0 0 0 
5 5 5 5 5 5 1 13 0 0 0 0 0 0 0 0 0 0 0 0 0 0 0 0 0 0 0 0 0 0 0 0 
5 5 5 5 5 5 6 0 0 0 0 0 0 0 0 0 0 0 0 0 0 0 0 0 0 0 0 0 0 0 0 0 
5 5 5 5 5 5 6 0 0 0 0 0 0 0 0 0 0 0 0 0 0 0 0 7 18 8 0 0 0 0 0 0 
5 5 5 5 5 1 13 0 0 0 0 0 0 0 0 0 0 0 0 0 0 0 0 14 5 11 0 0 0 0 0 0 
5 5 5 5 5 6 0 0 0 7 18 18 8 0 0 0 0 0 0 0 0 0 0 14 5 11 0 0 0 0 0 0 
5 5 5 5 5 6 0 0 0 9 5 5 11 0 0 0 0 0 0 0 0 0 0 14 5 11 0 0 0 0 0 0 
5 5 5 5 5 6 0 0 0 9 5 5 11 0 0 0 0 0 0 0 0 0 0 14 5 11 0 0 0 0 0 0 
5 5 5 5 5 6 0 0 0 12 3 3 13 0 0 0 0 0 0 0 0 0 0 14 5 11 0 0 0 0 0 0 
5 5 5 5 5 6 0 0 0 0 0 0 0 0 0 0 0 0 0 0 0 0 0 14 5 11 0 0 0 0 0 0 
5 5 5 5 5 6 0 0 0 0 0 0 0 0 0 0 0 0 0 0 0 0 0 9 5 11 0 0 0 0 0 0 
5 5 5 5 5 6 0 0 0 0 0 0 0 0 0 0 0 0 0 0 0 0 0 9 5 11 0 0 0 0 0 0 
5 5 5 5 5 6 0 0 0 0 0 0 0 0 0 0 0 0 0 0 0 0 0 9 5 11 0 0 0 0 0 0 
5 5 5 5 5 6 0 0 0 0 0 0 0 0 0 0 0 0 0 7 17 17 17 19 5 11 0 0 0 0 0 0 
5 5 5 5 5 6 0 0 0 0 0 0 0 0 0 0 0 0 0 9 5 5 5 5 5 11 0 0 0 0 0 0 
5 5 5 5 5 6 0 0 0 0 0 0 0 0 0 0 0 0 0 9 5 5 5 5 5 6 0 0 0 0 0 0 
5 5 5 5 5 6 0 0 0 0 0 0 0 0 0 0 0 0 0 9 5 5 10 5 5 16 8 0 0 0 0 0 
5 5 5 5 5 6 0 0 0 0 0 0 0 0 0 0 0 0 0 9 5 5 5 5 5 5 6 0 0 0 0 0 
5 5 5 5 5 6 0 0 0 0 0 0 0 0 0 0 0 0 0 12 4 5 5 5 5 5 6 0 0 0 0 0 
5 5 5 5 5 6 0 0 0 0 0 0 0 0 0 0 0 0 0 0 9 5 5 5 5 5 6 0 0 0 0 0 
5 5 5 5 5 16 18 8 0 0 0 0 0 0 0 0 0 0 0 0 12 2 4 5 5 1 13 0 0 0 0 0 
5 5 5 5 5 5 5 16 17 17 17 8 0 0 0 0 0 0 0 0 0 0 12 3 3 13 0 0 0 0 0 0 
5 5 5 5 5 5 5 5 5 5 5 6 0 0 0 0 0 0 0 0 0 0 0 0 0 0 0 0 0 0 0 0 
5 5 5 5 5 5 5 5 5 5 5 6 0 0 0 0 0 0 0 0 0 0 0 0 0 0 0 0 0 0 0 0 
5 5 5 5 5 5 5 5 5 5 5 16 17 8 0 0 0 0 0 0 0 0 0 0 0 0 0 0 0 0 0 0 
5 5 5 5 5 5 5 5 5 5 5 5 5 6 0 0 0 0 0 0 0 0 0 0 0 0 0 0 0 0 0 0 
5 5 5 5 5 5 5 5 5 5 5 5 5 6 0 0 0 0 0 0 0 0 0 0 0 0 0 0 0 0 0 0 
5 5 5 5 5 5 5 5 5 5 5 5 5 6 0 0 0 0 0 0 0 0 0 0 0 0 0 0 0 0 0 0 
5 5 5 5 5 5 5 5 5 5 5 5 5 6 0 0 0 0 0 0 0 0 0 0 0 0 0 0 0 0 0 0 
